1111111111111111111111118
0000000000000000000000000
0111111111111111111111311
0000000000000000000000000
1111111111111111111111110
0000000000000000000100010
0111111111111111110301010
0000000000000000010101030
1111111131313110010101010
0000000000009000010001000
#
100 6
0 100